############
#          #
#   P   ####
#         O#
#######    #
#    ##    
#    ##    #
#          #
#       XX #
#       # O#
############
